F       64		 ,   64  ,                 64
C 36, 34, 52
NO assets/DarkCastle_1_16x16.xpm
SO assets/DarkCastle_6_16x16.xpm
EA assets/DarkCastle_2_16x16.xpm
WE assets/DarkCastle_19_16x16.xpm
DOOR	assets/DarkCastle_11_16x16.xpm

# F	149,	82,		63
# C	44, 	4, 		20
# NO assets/inca_1_bright.xpm
# SO assets/inca_1_dark.xpm
# EA assets/inca_2_bright.xpm
# WE assets/inca_2_dark.xpm
# DOOR	assets/inca_blank.xpm

### I can't be bothered to document expected format. Go read the code.
### The 'b' sprite is reserved for barrels.
a assets/sprites/capyboy_tilemap.xpm		0.5		N	2
b assets/sprites/doom_barrel_tilemap.xpm	1.0		N	7



        111111111111111111111111 
        1000000000110000001000001
        1011000001110000000000001
        10a1000000000000000000001
111111111011000001110000000000001      
10000000001100000111011111-111111
1111011111111101110000001b001
11110111111111011101010010001        
11000000110101011100000010001
1000000000000000110000001b001
10000000000000001101010010001
11000001110101011111011110N0111          
11110111 1110101 1011110|0001
1111-111 1111111 111111111111
   101
   1001
    1001
     1001
      1001
       1001
        1001
         1001111111111111111
         100|000000000000001
         1111000001111111111111111
            1000001000000000000001
            1000000000000000000001
            1000001b00000000000001
            1111111111111111111111
